NO cub3d-tester/textures/wall.xpm


SO cub3d-tester/textures/bricks.xpm


WE cub3d-tester/textures/gold.xpm


EA cub3d-tester/textures/wood.xpm

F 220,111,119
C 225,111,0



 1111111111111111111111
100000000000S00000000001
 1000000000000000000001
  100000000000N0000001
   100000000000000001
    1000000N00000001
     10000000000001
      100000000001
       1000000001
        10000001
         100001
          1001
           11








