NO ./textures/wall.xpm


SO ./textures/bricks.xpm


WE ./textures/gold.xpm


EA ./textures/wood.xpm

F 220,111,119
C 225,111,0



1111111111
1111111111
1111111111
1111111111
10100000001
11111111111







