NO ./textures/wall.xpm


SO ./textures/bricks.xpm


WE ./textures/gold.xpm


EA ./textures/wood.xpm

F 220,111,119
C 225,111,0



 1111111111111111111111
100000000000S00000000001
 10000000000000000000011
  10000001234000000000001
   1000000000000000011111
    1000000000000001
     10000000000001
      100000000001
       1000000001
        10000001
         100001
          1001
           11








