NO ./textures/wall.xpm


SO ./textures/bricks.xpm


WE ./textures/gold.xpm


EA ./textures/wood.xpm

F 220,111,119
C 225,111,0



111
10 
1001
1E11
1111
