 1111111111111111111111
100000000000S00000000001
 1000000000000000000001
  10000000000000000001








