NO cub3d-tester/textures/wall.xpm


F 220,111,119
C 225,111,0



 1111111111111111111111
100000000000S00000000001
 1000000000000000000001





