NO ./textures/wall.xpm


SO ./textures/bricks.xpm
NO ./textures/wall.xpm



WE ./textures/gold.xpm


EA ./textures/wood.xpm

WE ./textures/gold.xpm

F 220,111,119
C 225,111,0

C 225,111,0

111
100100
10W1
111111
0

         
        
        