NO ./textures/wall.xpm


SO ./textures/wall.xpm
EA ./textures/wall.xpm

WE ./textures/wall.xpm


F 0,0,0
C 0,0,0

111111111111111111111111111111
100000000000000000000000000001
101111111111110000000011100001
10000000000000000110000000001
100000000000000000110000000001
10000000000100000000100000001
101111110001110110000100100001
100000000000000000000111110001
10111111000010000000100000001
101000010000100000000000000001
101000010000100111111110000001
101000010000100000000000000N1
101000010000100111111110000001
10000000000100000000010000001
100000110000100110000110000001
100000110000100000000000000001
100000000000100000000000000001
111111111111111111111111111111
1111111111111111111
111111111111111111111111111111
