NO ./textures/wall.xpm
SO ./textures/wall.xpm
WE ./textures/wall.xpm
EA ./textures/wall.xpm

F 18,53,25
C 153,204,255

111111111111
1         11
111111111110001
10000001111111111111 110011
10S000000001
111111111111
11         1
111111111111
