NO ./textures/wall.xpm
SO ./textures/wall.xpm
WE ./textures/wall.xpm
EA ./textures/wall.xpm
F 200,111,119
C 225,111,0
111111111111
101010000001
100100110111
101000000001
110000000111
111011010101
110001001001
10001E111001
111000000011
110010110111
101001010101
111111111111

