NO ./textures/wall.xpm
SO ./textures/wall.xpm
WE ./textures/wall.xpm
EA ./textures/wall.xpm
F 200,111,119
C 225,111,0
11111111111111
10001000000011
11010000010101
11111101111001
10110000N01101
10101000011001
10110010000001
11001101101001
11001001100101
11110101110001
11101011010101
10101000001101
11111111111111

