NO ./textures/wall.xpm
SO ./textures/wall.xpm
WE ./textures/wall.xpm
EA ./textures/wall.xpm
F 200,111,119
C 225,111,0
1111111111111111
1100111011111111
1000111001010111
1000010111101111
1010000001000011
1011000100010011
1101001010101101
1100111100001001
100110000N000101
1000011001000001
1100010010101111
1010010000001111
1001110001100001
1111000101011101
1101111101101001
1111111111111111

