NO ./textures/wall.xpm
SO ./textures/wall.xpm
WE ./textures/wall.xpm
EA ./textures/wall.xpm
F 200,111,119
C 225,111,0
111111111111111111
100001000111010101
111110011011001001
100010000001000001
110011010001000111
101111111001110111
100001110110110011
110001000000100011
110100110001001111
101101001000100101
100001001E00010101
111000010100100101
101000011001000001
101000101001011011
110101010010011001
101100011010000001
100001011000001011
111111111111111111

