NO ./textures/wall.xpm
SO ./textures/wall.xpm
WE ./textures/wall.xpm
EA ./textures/wall.xpm
F 200,111,119
C 235,111,0
11111111111111111111
10001000110100101111
10001010111101101111
11110010101011010111
10010110011010011011
10010000110000010001
10110001111110110101
10010010111010010001
11000011000101100111
100110001S1010001111
10000111001000001111
11000010111001111111
11000100001111010001
10011110100111010111
10001010101000010111
10010001000000100011
10010101110000001011
10011000110001000111
11001101010111001011
11111111111111111111

