NO ./textures/wall.xpm
SO ./textures/wall.xpm
WE ./textures/wall.xpm
EA ./textures/wall.xpm
F 200,111,119
C 225,111,0
1111111111111111111111
1000010000011101010101
1010101111010000001001
1001001010101110101001
1100001100001101001011
1110110011110011001101
1110000000001011001001
1010001001110001010101
1000001110101011110011
111001101110E111001011
1111100010110010001101
1001100100100011100101
1010001000111111001001
1001011100010101100101
1010110100000000100011
1001100011001011000001
1001011010101000000101
1101011000000101010011
1110010000010010010001
1000101011011010010111
1111001110001000101111
1111111111111111111111

