NO ./textures/wall.xpm
SO ./textures/wall.xpm
WE ./textures/wall.xpm
EA ./textures/wall.xpm
F 200,111,119
C 225,111,0
111111111111111111111111
111001001011001000100101
101101000010000010000101
10111E010000110101011011
110110001110111100001001
110101010111001011100011
100010010101100111001101
111001000001011001000111
100001110010001011000101
111000001110110001101111
100100000000100000111111
111000110001000001111101
101001001101100100011101
110100011001101101000001
110000010101101111000001
111010011000101010001101
101001100110010011001011
101100101010101111001011
111000010000101010010101
101011110010000000111001
100110000100100000001101
100100000110100011010001
101001001110100011000011
111111111111111111111111

