NO ./textures/wall.xpm
SO ./textures/wall.xpm
WE ./textures/wall.xpm
EA ./textures/wall.xpm
F 200,111,119
C 225,111,0
11111111111111111111111111
11001100100000010100111101
10101001000110011101111111
10010000100000111000001001
1110101101001011010001E001
10001110000001101100101111
11000001111010111100100101
11100101000001101000001111
10101010011000101010010001
11101110010110101110010001
11001010010110010011001111
11000100111100010111111111
10000001100101001101101001
10001110011100110000010011
11010111000000011000100111
10010010010111010100110011
10100001101000101111110101
11001100000001110101100011
10010110000000010001101111
10000101110101100111000001
10001111110001010001101101
10100011000001100100010101
11111001010001010101010011
10000000000001111010101001
11111100001110101000001111
11111111111111111111111111

