NO ./textures/wall.xpm
SO ./textures/wall.xpm
WE ./textures/wall.xpm
EA ./textures/wall.xpm
F 200,111,119
C 225,111,0
1111111111111111111111111111
1010000000101000110000001111
1000011000011001100100000001
1010110101100100010100000001
10000101000E1001010111001011
1010101001100000100101010011
1100111001010111110011000001
1000100011100000100010110001
1000110000110000010011100111
1011010011001001000100010111
1111000001001000001101100101
1110100110001000000100000001
1001010000100000000101000001
1100100100000001111110010111
1100001001000000011011011011
1110100110110101000000111001
1101010011001100010000001011
1011010001000011110000101001
1101000011101001101011011011
1010111000100001000100100011
1000010110111000011100010001
1110100100010000001001101111
1000100101001100010010011001
1111010001101111001110011001
1000110100100011001111000001
1000100100010001110011101001
1010001101011000100011101001
1111111111111111111111111111

