NO ./textures/wall.xpm
SO ./textures/wall.xpm
WE ./textures/wall.xpm
EA ./textures/wall.xpm
F 200,111,119
C 225,111,0
111111111111111111111111111111
101110010001111000000010101011
101010010101011000011100111101
101011011000010000001101110011
110001001011001001100000001001
100001000110010010010001011101
110000001001100111111011100001
110000010000100011000000011101
110111000010010101000111000101
111000000010111000001010001011
101101111010000011110000001111
100101111100001100110000010111
100000100010011011100101010101
111000010110000001011111111011
100111000110101100010100000011
110001010110111001100000010011
100010000010110100001111101011
100001001010101101100101001011
100100010101100011000110100101
110000100101010001001100000011
110100011000110100000100111001
101001100011001011011011010001
101101000010010001000011000011
101001011101100011010000000001
101100000011001110000110101001
100100110101011011011111000011
100110100100000110E00110001101
111100001101000000110010011111
100111000000100110101111000101
111111111111111111111111111111

