NO ./textures/wall.xpm
SO ./textures/wall.xpm
WE ./textures/wall.xpm
EA ./textures/wall.xpm
F 200,111,119
C 225,111,0
11111111111111111111111111111111
10011101100110110100111100001001
11001000010011001001001100000001
11011010010011101000001101000001
10110101111001001100101010001001
10101011010010010100000110000011
10100110110000011000101111010101
10011100000101011010110001110011
10010100010000101111011000000011
10001101110101001100000000000111
11000011100010000001000001110101
10001001111001111011101011000011
10011100010111000000010000101011
11000101010011001001000110000011
10000101001011000010001000100011
10111001000110111000110000010001
10001000101110000001000111100101
11101001011100100111011110011011
11001001000100000010110001011001
11000011000000100110010000100011
11010100001001100101001111000001
11001010100001011000001110000001
10000000001000010000001000101011
11011000100100011001000110100111
10101110001111010000111000010101
10010000011110010010101110010111
11101001001000011000001101110101
11110100101110010010111000010111
10000001111010000111010111001001
10010100001001100001011101000001
1001101110000010E110010010000001
11111111111111111111111111111111

