NO ./textures/wall.xpm
SO ./textures/wall.xpm
WE ./textures/wall.xpm
EA ./textures/wall.xpm
F 200,111,119
C 225,111,0
1111111111111111111111111111111111111
1110100010000101100011011000000001101
1101011000100000111011E00100010001101
1100100001000001100000100011101000011
1101000101101010101000001001010000101
1010000010001100001000100011100000011
1011101000100100011011101110111000101
1100100000000111011111001101101010101
1100001010001010110001100100000010101
1010100011000100010101010011010111101
1101000011111000101000000001000101011
1101111010000010111110011001001110001
1001101100000010000100011100000010011
1001001011000110100000001111100001101
1000000010010001001101011101000110111
1011101000100001100010101001000000001
1001000011101101001110000010000001111
1010000000000000100000000101100010001
1110111001010110100010011011011100001
1100010000001010001101100000000101101
1100100000101000010001100110010011011
1001101001000101011000010000110000011
1001011000010110001000000100001100011
1010100100010011100100110101110110001
1001001001100010001010000110011100011
1100111100100111110010110011010101001
1010101010011001010011101001010010111
1001010010000100000011001001001010101
1100000001111011001000000111100001001
1100100110001010111001110011010100011
1011111000100100100000111101010111101
1011001100100111010001000111001001001
1000110110111001010100010001100110001
1100100110000010100010001010100111011
1111101000000010100110000001110100001
1011000101010110111000011101010011011
1111111111111111111111111111111111111

