NO ./textures/wall.xpm
SO ./textures/wall.xpm
WE ./textures/wall.xpm
EA ./textures/wall.xpm
F 200,111,119
C 225,111,0
111111111111111111111111111111111111111111
110000000000100100111001011101100000110101
100100010000000010001001100E00000000000001
101011111101100101010100100101110000101101
110100000100000001101111101010001110000011
111001100001110001001110000110001110011011
110001001000110011010100101000001100000111
111000100010101001100000000000101010110111
110110110010101001100010100100100100000001
101101010100011001110110000001011100000011
100100000010100100011101000001010100001001
100010000000000101000000100100100011101001
111001111100100010010101011011011110000001
110110110110010010111100001011111001000001
111101100110110010010000110001001100100111
110010111101001010000010101110010100011101
101101000001100110010010001100110000010001
100101000000000110001001101101011101100001
100101101100100110100110111011110001000001
100000010010000010110111001111011101001101
110101001110110111011010111100111010000111
110001111101011101010100000010100010010111
101001110011001011010000110000011111000101
110011001000000110001101001100101000101101
110111010000100010001110100000111011000001
111010001111100101100000110110101011010111
110000110011010010000010101011111100010111
110111010000100001000010110101101001100011
111110101111001000001000000100000001010111
111011011011110011100010000001010000010011
101001100000000011110010001010101001010011
100001110011000100011110000011110000010001
101010111000111101000000001110011111010011
100100010101111000101000101000010110000001
101100111101000010011100101000100000101011
100001001111111001101000100010011000011101
111110110110000101011010101001000110110001
101010000101000010110000001011001100000001
110001110010010101000001101111100010010001
100001100001100100010110100000101010100111
100001100001101100101100110100010110110001
111111111111111111111111111111111111111111

