NO ./textures/wall.xpm
SO ./textures/wall.xpm
WE ./textures/wall.xpm
EA ./textures/wall.xpm
F 200,111,119
C 225,111,0
1111111111111111111111111111111111111111111111111111
1010010110101100111010010001100001101101100101011001
1000100100010111010000010010100001000011011010001001
1011100001110100100000001100000011000100000101010101
1000110001000101100010110010011000010101001010011111
1110000110010000001010010001010000001111111011101111
1011111001110000010001010101100111100100001001010011
1000000011110000001011100001010110000000E00011000011
1010101011001001100001001110111001011001000001101101
1011100010010010111010011010001011000001001000110001
1000010000010000001001100000110010010101011110000011
1011100011100000000000011001010011110001100110000001
1110001001100101000010100011101000000011110110000101
1000011110001101100101110000011011010110001000000001
1010100000000011000010000111101100010001000001011101
1000000010010000010100011000101011110000000001000011
1010101100111001000100100111000000110110011110101011
1111100000000001110110010110011111011010010000000011
1110111011000101111000000111101101101010010000000101
1111010110011000100001101001011000110101110000001011
1101000001101010101100010001001000111001110000100001
1000001001101011000000000010001010000010001101100001
1001001011000011110010000010100010011000011010011011
1101000000110010011000111001000110110110011011011001
1111111000101100110010000010000011100001010101100111
1011001110000001101100000000000010101111001000010101
1010111001100101010001001001100110001000010011000111
1011011110010010111010000110011010100000010100110001
1110100000100110100010111000001000001100010100100011
1100100100010001010100100001001101011011000100010011
1001010000110101110010111000111011100001001110100001
1001000000110010101110111101000110101001000010100101
1111100111011110100101000001100001100000100100001001
1110110001001001100100100111011000110010001111110001
1010100010001101100111011000110011101101100100011011
1111000101100010100000000001111001000100011100100001
1010100011000010000100000111110100000111000100100011
1111000000110100000001001110100110110010011110101111
1100000110010000101011000000000011101010010010111001
1011111001011100111001110100100101000100101001000001
1101010101000100101010001001110100111101111011001111
1010000100000010110011110100001110000000010110000101
1001011001101000110010000100001011110100011001010001
1001100100011100101011110100011110010001000010100101
1001000111111010010010000110000110100101011100010011
1100011101111010001101010011100011101010011001001001
1000000010000110011110110101000011110010001110000001
1101001001000000010011000000000110111100100000010111
1011111010000110011010010010001011000010100101111001
1000110110000001110100000001001000110110000011100001
1000111010111100001010000101011010010010000011111101
1111111111111111111111111111111111111111111111111111

