NO ./textures/wall.xpm
SO ./textures/wall.xpm
WE ./textures/wall.xpm
EA ./textures/wall.xpm
F 200,111,119
C 225,111,0
1111111111
1010000101
1000010001
1011001101
1000101011
1110101001
100000W101
1110011001
1010011011
1111111111

