NO ./textures/wall.xpm


SO ./textures/wall.xpm


WE ./textures/wall.xpm


EA ./textures/wall.xpm

F 220,111,119
C 225,111,0



      1110
      1110
1111111110
1111111111
0110000001
0111011101
011101 101
0111011101
01110000W1
0111111111








