NO ./textures/wall.xpm


SO ./textures/wall.xpm


WE ./textures/wall.xpm


EA ./textures/wall.xpm

F 220,111,119
C 225,111,0



1111111111111
1100000000011
1100000000011
1100000S00011
1100000000011
1100000000011
1100000000011
1100000000011
1111111111111








