NO ./test_maps/textures/bluestone.xpm


SO ./test_maps/textures/bluestone.xpm


WE ./test_maps/textures/bluestone.xpm


EA ./test_maps/textures/bluestone.xpm

F 200,111,119

C 225,111,0

1111111
10000011111
1E100000001
11101111111
10001
11101
10001
11111


