   WE                            ./test_maps/textures/wall_small_uneven.xpm
NO ./test_maps/textures/wall_big.xpm



SO ./test_maps/textures/wall_small_uneven_2.xpm

F      17,    38,     64

EA ./test_maps/textures/wall_small_uneven_3.xpm



C 218, 234, 235


111111111
100000001
100010001
100000001
1010W0101
100000001
100010001
100000001
111111111