   WE                            ./test_maps/textures/wall.xpm
NO ./test_maps/textures/wall.xpm



SO ./test_maps/textures/wall.xpm

F      17,    38,     64

EA ./test_maps/textures/wall.xpm



C 218, 234, 235


01111111111111111110
10000000000000000001
10000000000000000001
10001010101010101001
10000000000000000001
10000000000000000101
10000000010000000101
100000001N1000000101
10000000000001111001
10000000000000000001
10000000000000000001
10000000000000000001
10000000000001111001
10000000000000000001
10000000000000000001
10000000000000000001
10000000000001111001
10000000000000000001
10000000000000000001
10000000000000000001
10000000000001111001
10000000000000000001
10000000000000000001
10000000000000000001
11111111111111111111

