NO ./test_maps/textures/bluestone.xpm


SO ./test_maps/textures/bluestone.xpm



WE ./test_maps/textures/bluestone.xpm


EA ./test_maps/textures/bluestone.xpm

F 200,111,119

C 225,111,0


11111111111111111111
10000000000000000001
10000000000000000001
10001010101010101001
10000000000000000001
10000000000000000101
10000000111000000101
100000001N1000000101
10000000000001111001
10000000000000000001
10000000000000000001
10000000000000000001
10000000000001111001
10000000000000000001
10000000000000000001
10000000000000000001
10000000000001111001
10000000000000000001
10000000000000000001
10000000000000000001
10000000000001111001
10000000000000000001
10000000000000000001
10000000000000000001
11111111111111111111