   WE                            ./test_maps/textures/wall_1.xpm
NO ./test_maps/textures/wall_2.xpm



SO ./test_maps/textures/wall_3.xpm

F      17,    38,     64

EA ./test_maps/textures/wall_4.xpm



C 218, 234, 235


111111111111111111111
100000000000000000001
100000000000000000001
100010000000000000001
100010000000000000001
100000000000000000001
100000000000000000001
100010011100000000011
100000000000000000001
100000000000000000001
1000000000S0000000001
100000000000000000001
100000001000000000001
100000001000000000001
100000010000000000001
100000100000000000001
100001000000000000001
100000000000000000001
100000000000000000001
100000000000000000001
100000000000000000001
111111111111111111111