NO ./textures/north.xpm
EA ./textures/east.xpm
SO ./textures/south.xpm
WE ./textures/west.xpm
F 17,38,64
C 218,234,235

111111111
100000001
100010001
100000001
1010W0101
100000001
100010001
100000001
111111111